40 80 186
X______________________________________________________________________________X
X______________________________________________________________________________X
X______________________________________________________________________________X
X______________________________________________________________________________X
X______________________________________________________________________________X
X______________________________________________________________________________X
X______________________________________________________________________________X
X______________________________________________________________________________X
X______________________________________________________________________________X
X______________________________________________________________________________X
X______________________________________________________________________________X
X______________________________________________________________________________X
X__________________XXXXXXXXXXXXXXXXXXXXXXXXXXXXXXXXXXXXXXXXXXX_________________X
X_______________________________________XX_____________________________________X
X_______________________________________XX_____________________________________X
X_______________________________________XX_____________________________________X
X_______________________________________XX_____________________________________X
X_______________________________________XX_____________________________________X
X_______________________________________XX_____________________________________X
X_______________________________________XX_____________________________________X
X________________________________XXXXXXXXXXXXXXXX______________________________X
X_______________________________________XX_____________________________________X
X_______________________________________XX_____________________________________X
X_______________________________________XX_____________________________________X
X_______________________________________XX_____________________________________X
X_______________________________________XX_____________________________________X
X_______________________________________XX_____________________________________X
X_______________________________________XX_____________________________________X
X__________________XXXXXXXXXXXXXXXXXXXXXXXXXXXXXXXXXXXXXXXXXXX_________________X
X______________________________________________________________________________X
X______________________________________________________________________________X
X______________________________________________________________________________X
X______________________________________________________________________________X
X______________________________________________________________________________X
X______________________________________________________________________________X
X______________________________________________________________________________X
X______________________________________________________________________________X
X______________________________________________________________________________X
X______________________________________________________________________________X
X______________________________________________________________________________X
