40 80 186
X______________________________________________________________________________X
X______________________________________________________________________________X
X______________________________________________________________________________X
X______________________________________________________________________________X
X______________________________________________________________________________X
X______________________________________________________________________________X
X______________________________________________________________________________X
X______________________________________________________________________________X
X______________________________________________________________________________X
X______________XXXXXXXXXXXXXXXX_________X___________XXXXXXXXXXXXXXXX___________X
X____________XX_________________________X__________________________XX__________X
X___________XX__________________________X___________________________XX_________X
X__________X____________________________X____________________________X_________X
X__________X____________________________X____________________________X_________X
X__________X____________________________X____________________________X_________X
X__________X____________________________X____________________________X_________X
X__________X____________________________X____________________________X_________X
X__________X____________________________X____________________________X_________X
X__________X____________________________X____________________________X_________X
X__________X________________XXXXXXXXXXXXXXXXXXXXXXXXX________________X_________X
X__________X____________________________X____________________________X_________X
X__________X____________________________X____________________________X_________X
X__________X____________________________X____________________________X_________X
X__________X____________________________X____________________________X_________X
X__________X____________________________X____________________________X_________X
X__________X____________________________X____________________________X_________X
X__________XX___________________________X___________________________XX_________X
X___________XX__________________________X__________________________XX__________X
X____________XXXXXXXXXXXXXXXXXX_________X___________XXXXXXXXXXXXXXXX___________X
X______________________________________________________________________________X
X______________________________________________________________________________X
X______________________________________________________________________________X
X______________________________________________________________________________X
X______________________________________________________________________________X
X______________________________________________________________________________X
X______________________________________________________________________________X
X______________________________________________________________________________X
X______________________________________________________________________________X
X______________________________________________________________________________X
X______________________________________________________________________________X
