40 80 204
X______________________________________________________________________________X
X______________________________________________________________________________X
X______________________________________________________________________________X
X______________________________________________________________________________X
X______________________________________________________________________________X
X______________________________________________________________________________X
X______________________________________________________________________________X
X______________________________________________________________________________X
X____________________X______________X______________X___________________________X
X___________________X_X____________X_X____________X_X__________________________X
X__________________X___X__________X___X__________X___X_________________________X
X_________________X_____X________X_____X________X_____X________________________X
X__________________X___X__________X___X__________X___X_________________________X
X___________________X_X____________X_X____________X_X__________________________X
X____________________X______________X______________X___________________________X
X______________________________________________________________________________X
X______________________________________________________________________________X
X______________________________________________________________________________X
X______________________________________________________________________________X
X___________________________X_______________X__________________________________X
X__________________________X_X_____________X_X_________________________________X
X_________________________X___X___________X___X________________________________X
X________________________X_____X_________X_____X_______________________________X
X_________________________X___X___________X___X________________________________X
X__________________________X_X_____________X_X_________________________________X
X___________________________X_______________X__________________________________X
X______________________________________________________________________________X
X____________________X______________X_______________X__________________________X
X___________________X_X____________X_X_____________X_X_________________________X
X__________________X___X__________X___X___________X___X________________________X
X_________________X_____X________X_____X_________X_____X_______________________X
X__________________X___X__________X___X___________X___X________________________X
X___________________X_X____________X_X_____________X_X_________________________X
X____________________X______________X_______________X__________________________X
X______________________________________________________________________________X
X______________________________________________________________________________X
X______________________________________________________________________________X
X______________________________________________________________________________X
X______________________________________________________________________________X
X______________________________________________________________________________X
